###########################################################
#......##......*#........####...##.....#.......#......#####
#.####....#####.#.#.........#.#....###.#.#####...##...#####
#.####....#####.#.#.........#.#....##..#.#...#...#....#####
#.#############...#######...#.#######.##.#.#.##############
#......#......#...#.....#...#.#....##....#.#.#...#....#####
######.#.####.#####..##.....#...##.#######.#.#..##.########
#......#....#.....#..##...*.#...#..##......#.#...#.#..#####
#.#########.#####.#..############.###.######.###.#.#..#####
#.####......#.....#.............#..##..#...#.....#.#..#####
#.####.######..##.########.####.##.###.#...#######.#..#####
#.####..#...#...#......###....#....##..#.#.#...#...#..#####
#.#####.#.#.###.#####..####...#######.##.#.#.#.#.###..#####
#.....#.#.#.....#...#.....#...#...#...#..#...#.#...#..#####
#####.#.#.#######...##....#*..#.#.#.#.#.######.###.#..#####
#...#.#.#.#...#...#.......#...#.#...#.#..#.....#...#..#####
#.#.#.#.#...#.#.########..#...#.########.#.#####.###..#####
#.#.#.#.#...#.#.#....###..##...........#.#.#####...#..#####
#.#...#.#####.#.#..###.....#.#########.#.#.#...###.#..#####
#.#...#.#####.#.#..###.....#.........#.#.#.#.#.#...#..#####
#.#####.#####.#.##.######..#########.#...#...#.#..#########
#.#####.....#.#..#..#####...###...##.#...#...#.#..#...#####
#.#########.#.##.##.#######.###...##.#########.#..#.#.#####
#.....#..*#.#.#..#..###...#.###.#....#.........#....#.#####
#####.#...#.#.#.##.####...#.###.######.##############.#####
#...#.#.#...#.#.#..#....#.#.###...##...#...###........#####
#.#.#.#.#####.#.#.##...##.#.#####.##..##.#.###.############
#.#...#.###...#.#.##....#.#.###...##..#..#.###........#####
#.#####.###.###.#.###...#.#.###.####..#.##.################
#.....#...#.##..#.##....#...###...##..#.#..###.......######
#####.###.#.##.##.##.############.##....#.####.####.#######
#.@...#...#.##.#..##...#......###.##...*#.#....#.....######
#..####.###.##.#.#####.#.####.###.#######.#.##.#.###.######
#.%####.##..##*#.#.....#....#.....##....#.#.##.#.#...######
###########################################################